+-+-+-+-+-+-+-+-+-+-+-+-+-+-+-+-+-+-+-+-+-+-+-+-+-+-+-+-+-+-+
| |   | | |     | | |   |   |   | | | | | |     | |   | |   |
+ +-+ + + +-+ + + + + +-+ +-+ + + + + + + +-+ +-+ + + + + + +
|   |     | | | |   | | | | | | | |               | | | | | |
+-+ + + +-+ + + +-+ + + + + +-+ + + +-+ + + + + + + + + +-+ +
| | | | | |   |   | |     | | | | | |   | | | | | | | | |   |
+ + + + + + + +-+ + + + + + + + + +-+ + + +-+ + + + + + + +-+
| | | | | | | |     | | | | | | | |   | | | | | |   | |   | |
+ + +-+ + + + + + + +-+ +-+ + + + + +-+ + + + + +-+ + + +-+ +
|   |     | | | | |   | | |   |     |   | |   | | | | | | | |
+ + + + + +-+ +-+ +-+ + + + + + + +-+ + + + + + + +-+ + + + +
| | | | | | |   |   | |     |   | |   | | | | | | |   | | | |
+ + + + + + +-+ + + +-+ + + + + + + + + +-+ +-+ + + + + + + +
| |   | | |   | | |   | | | | | | | | | | | |     | | |   | |
+ + + +-+ + + +-+ + + + + +-+ + + +-+ +-+ +-+ +-+ +-+ +-+ + +
| | | |   | |     | | | | |   | |   | | | | | | | | | | |   |
+-+ +-+ + + +-+ +-+ + + +-+ + + + + +-+ + + + + + + + + + + +
|   |   | | | | | | | |   | | | | |     | | | |   |     | | |
+ + + + + + + + + + + + + + + +-+ + + +-+ + + + + +-+ +-+ + +
| | | | |     | | | | | | | | |   | | | | | | | | | | | | | |
+ + +-+ +-+ +-+ + + +-+ +-+ +-+ + + +-+ + + +-+ + + + + + + +
| | | |   | | |   |   |   | | | | | | | | | |   |   | | | | |
+ + + +-+ + + +-+ + + +-+ + + + + + + + + + + + + +-+ + + +-+
| | | | | | | | | | | |   |   | | |     | | | | | | | | |   |
+ + + + +-+ + + + + +-+ +-+ +-+ +-+ + + + + + + + + + + + + +
| | |   | |   | | | |   |   | | | | | |   | | | | | | | | | |
+ + + + + +-+ + + +-+ +-+ +-+ + + + + +-+ + + + + + + + + +-+
| |   | | |   | | | | | |     | | | | |   |   | | |   |   | |
+ + + + + + + + + + + + + + +-+ + + + + +-+ + + +-+ + + + + +
| | | | | | | |     | | | | |   | | | | |   | |   | |   | | |
+ +-+ + + + + +-+ + + + + +-+ +-+ +-+ +-+ +-+ +-+ + + +-+ + +
| | | |   | |   | | |   | | |       | | |   | | | | | |   | |
+ + + + +-+ +-+ +-+ +-+ +-+ +-+ + + +-+ +-+ +-+ +-+ + + + + +
| |   | | |   | | | | | | | |   | |     | | | | | | | | | | |
+ + + + + + + + + + + + + + + + + + + + + + + + + +-+ + + + +
| | | | | | | |   | | | | |   | | | | | | | | | |     | |   |
+ + + + + + +-+ +-+ + + + + +-+ +-+ +-+ + + + + + + +-+ + + +
| | | |   |   |   |       |   |   |   |   |     | |   | | | |
+-+-+-+-+-+-+-+-+-+-+-+-+-+-+-+-+-+-+-+-+-+-+-+-+-+-+-+-+-+-+
